111111  11111
11110111100C1
  10011111001
111P11E000111
11111111111
