1111111111111
1E010000000C1
100C011111001
1C0011E000001
1111111111111
